10
6 6 6 6 6 6 6 6 6 6 6 6 6 6 6
6 0 0 0 0 0 0 0 0 0 0 0 0 0 6
6 0 0 0 0 1 1 1 0 0 3 3 3 0 6
6 0 0 0 0 0 0 0 0 0 3 3 3 0 6
6 0 0 0 2 0 0 0 0 0 0 0 0 0 6
6 0 0 0 2 2 2 2 2 1 1 1 0 0 6
6 0 0 0 1 1 2 2 2 2 2 2 0 0 6
6 0 0 0 0 0 0 0 0 0 0 0 0 0 6
6 4 0 1 1 0 0 0 0 0 0 0 0 0 6
6 4 0 1 1 0 0 0 0 0 0 0 0 0 6
6 4 0 0 0 0 0 0 0 0 0 0 0 0 6
6 4 4 4 0 0 0 0 0 0 0 0 0 0 6
6 4 2 4 0 0 1 1 1 0 0 0 0 0 6
6 4 4 4 0 0 1 7 1 0 0 0 0 0 6
6 6 6 6 6 6 6 6 6 6 6 6 6 6 6