30
06 12 06 12 06 12 06 12 06 12 06 12 06 12 06 12 06 12 06 12 06 12 06 12 06 12 06 12 06 12
06 12 00 12 00 12 00 12 00 12 00 12 00 12 00 12 00 12 00 12 00 12 00 12 00 12 00 12 06 12
06 12 00 12 00 12 00 12 00 12 00 12 03 12 03 12 03 12 00 12 00 12 00 12 00 12 00 12 06 12
06 12 00 12 02 12 02 12 00 12 00 12 03 12 03 12 03 12 00 12 00 12 02 12 02 12 00 12 06 12
06 12 00 12 02 12 02 12 00 12 00 12 00 12 00 12 00 12 00 12 00 12 02 12 02 12 00 12 06 12
06 12 00 12 02 12 02 12 00 12 00 12 04 12 04 12 04 12 00 12 00 12 02 12 02 12 00 12 06 12
06 12 00 12 02 12 02 12 00 12 00 12 01 12 01 12 01 12 00 12 00 12 02 12 02 12 00 12 06 12
06 12 00 12 02 12 02 12 00 12 00 12 01 12 01 12 01 12 00 12 00 12 02 12 02 12 00 12 06 12
06 12 00 12 00 12 00 12 00 12 00 12 01 12 01 12 01 12 00 12 00 12 00 12 00 12 00 12 06 12
06 12 02 12 02 12 02 12 02 12 00 12 01 12 01 12 01 12 00 12 02 12 02 12 02 12 02 12 06 12
06 12 00 12 00 12 00 12 00 12 00 12 00 12 00 12 00 12 00 12 00 12 00 12 00 12 00 12 06 12
06 12 00 12 01 08 01 09 01 12 00 12 00 12 00 12 00 12 00 12 01 12 01 08 01 09 00 12 06 12
06 12 00 12 01 11 01 10 01 12 00 12 01 06 01 03 01 07 00 12 01 12 01 11 01 10 00 12 06 12
06 12 00 12 00 12 00 12 00 12 00 12 01 02 00 12 01 00 00 12 00 12 00 12 00 12 00 12 06 12
06 12 06 12 06 12 06 12 06 12 06 12 06 12 06 12 06 12 06 12 06 12 06 12 06 12 06 12 06 12

Ściąga do tworzenia mapy :P

left	up	right	down	corner1	corner2	corner3	corner4	cornerBig1	cornerBig2	cornerBig3	cornerBig4	full
00		01	02		03		04		05		06		07		08			09			10			11			12

air	brick	stone	green	water	road	endMap	kurak	kurakDEAD	(PS: Kuraków nie można umieszczać!!!)
00	01		02		02		04		05		06		07		08			(PS2: Jakbym zresztą k..a nie wiedział :D)